##########################
#    #                 #.#
#    #      $          #.#
#  $ #                 # #
#  $ #                   #
#           #        $   #
#       ..  #            #
#    #      #      *     #
#    #      #            #
#    #      #            #
#@   #      #    #       #
##########################