#############
#####   #####
##### $$#####
####   $  ###
#### $     ##
##### ..## ##
#   ##..*# ##
#    @..#  ##
##$###**## ##
# $   **    #
#   #####   #
#####   #####