
#######
#     #
# # # #
#. $*@#
#   ###
#####
