
  ####
 ##  #
##@$.##
# $$  #
# . . #
###   #
  #####
