
  ####
###  ####
#       #
#@$***. #
#       #
#########
