
  ######
  #    #
  #  $ #
 ####$ #
## $ $ #
#....# ##
#     @ #
##  #   #
 ########
