
  ######
  #    #
  # ##@##
### # $ #
# ..# $ #
#       #
#  ######
####
