
####
#  #######
#  . ## .#
# $#    .#
## ## # .#
 #    #  #
 #### #  #
  # @$ ###
  # $$ #
  #    #
  ######
