
#####
#   ## ####
#  $ ### .#
# $   $  .#
## $#####.# ####
# $  # # .###  #
#    # # .#  @ #
###  # #       #
  #### ##     ##
        #######
