
 #########
 #       #
##@##### #
#  #   # #
#  #   $.#
#  ##$##.#
##$##  #.#
#   $  #.#
#   #  ###
########
