
    ####
  ###  ##
 ## $   #
## $  # #
# @#$$  #
# ..  ###
# ..###
#####
