
########
# @ #  #
#      #
#####$ #
    #  ###
 ## #$ ..#
 ## #  ###
    ####
