
########
#      #
# #### #
# #...@#
# ###$###
# #     #
#  $$ $ #
####   ##
   #.###
   ###
