
  #########
###   #   #
# * $ . . #
#   $ ## ##
####*#   #
 #  @  ###
 #   ###
 #####
