
  #####
  # . ##
### $  #
# . $#@#
# #$ . #
#  $ ###
## . #
 #####
