
####     #####
#  ###   #   ##
#    #   #$ $ #
#..# ##### #  #
#  @    # $ $ #
#..#         ##
##   #########
 #####
