
 #######
 #  . .###
 # . . . #
### #### #
#  @$  $ #
#  $$  $ #
####   ###
   #####
