
 ######
 # .  #
##$.# #
#  *  #
# ..###
##$ # #####
## ## #   #
#  #### # #
#   @ $ $ #
##  #     #
 ##########
