
######
#    ####
#    ...#
#    ...#
######  #
  #  #  #
  # $$ ##
  # @$  #
  # $$  #
  ## $# #
   #    #
   ######
