
 #######
 #     #
## ###$##
#.$   @ #
# .. #$ #
#.##  $ #
#    ####
######
