
    #####
#####   #
#    $  #
#  $#$#@#
### #   #
  # ... #
  ###  ##
    #  #
    ####
