
## ####
####  ####
 # $ $.  #
## #  .$ #
#   ##.###
#  $  . #
# @ #   #
#  ######
####
