
  ######
  #    ##
 ## ##  #
 # $$ # #
 # @$ # #
 #    # #
#### #  #
#  ... ##
#     ##
#######
