
   ####
 ###  #####
 # $$ #   #
 # $ . .$$##
 # .. #. $ #
### #** .  #
#  . **# ###
# $ .# .. #
##$$.@. $ #
 #   # $$ #
 #####  ###
     ####
