
       ####
      ##  ###
####  #  $  #
#  #### $ $ #
#   ..# #$  #
#  #   @  ###
## #..# ###
 # ## # #
 #      #
 ########
