
#########
#       #
#       ####
## #### #  #
## #@##    #
# $$$ $  $$#
#  # ## $  #
#  # ##  $ ####
####  $$$ $#  #
 #   ##   ....#
 # #   # #.. .#
 #   # # ##...#
 ##### $  #...#
     ##   #####
      #####
