
###############
#..........  .####
#..........$$.#  #
###########$ #   ##
#      $  $     $ #
## ####   #  $ #  #
#      #   ##  # ##
#  $#  # ##  ### ##
# $ #$###    ### ##
###  $ #  #  ### ##
###    $ ## #  # ##
 # $  #  $  $ $   #
 #  $  $#$$$  #   #
 #  #  $      #####
 # @##  #  #  #
 ##############
