
######     ####
#    #######  #####
#   $#  #  $  #   #
#  $  $  $ # $ $  #
##$ $   # @# $    #
#  $ ########### ##
# #   #.......# $#
# ##  # ......#  #
# #   $........$ #
# # $ #.... ..#  #
#  $ $####$#### $#
# $   ### $   $  ##
# $     $ $  $    #
## ###### $ ##### #
#         #       #
###################
