
            #####
#####  ######   #
#   ####  $ $ $ #
# $   ## ## ##  ##
#   $ $     $  $ #
### $  ## ##     ##
  # ##### #####$$ #
 ##$##### @##     #
 # $  ###$### $  ##
 # $  #   ###  ###
 # $$ $ #   $$ #
 #     #   ##  #
 #######.. .###
    #.........#
    #.........#
    ###########
