
           #####
          ##   ##
         ##     #
        ##  $$  #
       ## $$  $ #
       # $    $ #
####   #   $$ #####
#  ######## ##    #
#.            $$$@#
#.# ####### ##   ##
#.# #######. #$ $##
#........... #    #
##############  $ #
             ##  ##
              ####
