
     ########
  ####      ######
  #    ## $ $   @#
  # ## ##$#$ $ $##
### ......#  $$ ##
#   ......#  #   #
# # ......#$  $  #
# #$...... $$# $ #
#   ### ###$  $ ##
###  $  $  $  $ #
  #  $  $  $  $ #
  ######   ######
       #####
