
####################
#                ###
# $#   $ ##  $    ##
#    $###    # $$ ##
#.###     $ $ ##  ##
#...#  #  #    #$  #
#..##$$#### $  #   #
#...#      $ ##  ###
#...$  ###  #    # #
##..  $#  ##   ##@ #
###.#              #
####################
