
####################
#    @##      #   ##
#    ##    $    $ ##
#  ###....# # #  ###
#   #....# # # $   #
### #...#  #       #
##  ##.#     $   $ #
##  $ $ ###  # # ###
## $       # # $   #
#### $  $# # # # $ #
####         # #  ##
####################
