
           ########
           #......#
   ####    #......#
   #  #########...#
   # $   $    #...#
   #  # # # # #   #
##### # # #@# #   #
#   # ### ### ## ##
#    $ # $ $ $ # #
# $$$  $   #     #
#   # ###$###$## #
### #  $   #     #
 ## $  # $ $ $ ###
 #  # ### ### ##
 # $          #
 #  ###########
 ####
