
####################
#   #    #   #   #@#
# $      $   $   # #
## ###..## ###     #
#   #....#$#  $### #
# $ #....#  $  $ $ #
#   #....# # # $ $ #
#   ##..##   #$#   #
##$##    ##  #  #$##
#   $  $     #  #  #
#   #    #   #     #
####################
