
####################
#  #  ##    #   @###
##    $    # $###  #
##$# $ ##$# $ $    #
#   $#    $      ###
# ##   $ ###  #....#
# # $# # # # #....##
#    $ $ #  #....###
##$ ###  $ #....####
#  # $        ######
#      # #    ######
####################
