
####################
#@     ###   #  #  #
# # #  #  $  $     #
#####     # $ $#$# #
#.#..#    ##$ $    #
#.....    $   #   ##
#.....    ###$##$###
#.#..#    $    #   #
#####     #  #$  $ #
#####  #  $    $ $ #
#####  #  #  #  #  #
####################
