
####################
#  #  # #    #  #  #
#   $      $ $     #
## #  #$###$##  ## #
#   $     $  #  $  #
# ###$##$#   # $   #
# #   $ $  ###### $#
# $  $$ $  #@#.#...#
# #     #  # #.#...#
# ########## #.....#
#            #.....#
####################
