
####################
#     #     @#...###
#     #      ##...##
# # # ##$## ## ....#
#   $ #   $$$  ....#
###$### $$  ### ##.#
#     $  #    # ####
#  $  #  ###  # #  #
## #$##    $  $$   #
#   $ ##   #  # #  #
#     #    #  #    #
####################
