
####################
#....###           #
#....##### #  #$# ##
#....###   #$  $   #
#....###    $  #$$##
##  #### $#  #$ $  #
##  ####  $  $  #  #
#@  ####$###$## $  #
##        #  #  $  #
##   ###  #  $  ####
########  #  #     #
####################
