
####################
#@     #   #       #
## ### ##  #### # ##
#    # #  $$       #
#  # # # $ # $ ## ##
#     $ #  #$$ #   #
#  ###  #      ## ##
#..#.# $ #  $ #    #
#..#.#  $ # ## $$  #
#....##   $$  $  # #
#.....##        #  #
####################
