
####################
#   #   #    #   #@#
#   $  $     # $ # #
##$# $### #    $$# #
#  #  #.###  #$ $  #
#  #$#....#  # ### #
# $  #.....##    # #
##$  #.#....#$$ $  #
#  ######..## #  # #
#  $         $ ### #
#   #   #        # #
####################
