
####################
#      ....#    ####
#      ....        #
# # ##########     #
# #$   #      ###..#
#  $   #$$###   #..#
# $ ### $   $   #..#
# $ #   $ $ #  ##..#
#  #  $$ # $ ##   ##
#@## $#  $  $     ##
##       ##   #  ###
####################
