
######  #####
#    #  #   #
# $  #### $ #
# $      $  #
#  ###@###$ #
########## ###
#..   ##     #
#..   ##$    #
#..   ## $   #
#..   ## $   #
#..     $ $  #
###  #########
  ####
