
####################
#  #     #  ##    ##
# $#   $ #     ##  #
# $  $  #..#     $ #
# $ $  #....#   # ##
# $#  #......### $ #
#   #  #....#  #$  #
# $  ####..#   #   #
## $   ## # # $  $##
### $    $#@$ $#   #
####   #       #   #
####################
