
####################
#        #   #@ #  #
# $$  #$$# # #  ## #
#  # $ $ #$$ #     #
## #  #  # # #  #  #
#   ##       #     #
#   # $ #   #   #  #
# $ #$ #   #  $ #..#
##$ #  ####    #...#
#  $          #....#
#   #  #     #.....#
####################
