
####### #########
#     # #   ##  #
# ### # #   $   #
# # $ ###   $   #
#   $$      ##$ #
#    ####   ##  #
#@############ ##
###..    #####$ #
  #..    ####   #
  #..       $$  #
  #..    #### $ #
  #..    #  #   #
  ########  #####
