
#######
#     ##########
#     #    #  ##
# $   #   $ $  #
#  $  #  $ ##  #
# $$  ##$ $    #
## #  ## #######
## #  ##    ...#
#  #$       ...#
#   $$      ...#
#     ##@#  ...#
################
