
 ##################
 #   $       ...#.##
 #       ####..... #
 # #######  #..... #
 # #    $ $ ##....##
 # #  $ # # ###...#
 # # $@$ $  ##### #
## #  $  $ $$   $ #
#  #$# $#   # $## #
# ##    ## ## $ # #
# # $# $ $  #     #
# #         #######
# ########$##   #
#        #  $   #
########    #####
       ###  #
         ####
